11111111111111111111111111
11111111111200111111111111
11111111111000111111111111
11111111111000111111111111
11111111111101111111111111
11111111111101111111111111
11111111111000111111111111
11111000001000111000011111
11111000001000111000010001
11100000000000000000000001
11111000001000111000010001
11111110111000111110111111
11111110111101110000001111
11111100011000110000001111
11111100000000110000001111
11111100011000111110111111
11111111111101111100011111
11111111100000011100010001
11111111100000000000010001
11111111100000011100000001
11111111111101111100010001
11111111110000011100010001
11111111110000011111111111
11111111110000011111111111
11111111110000011111111111
11111111111111111111111111
