11111111111111111111111111
11111111111200111111000011
11111111111000111111000011
11111111111000111111000011
11111111111101111111110111
11111111111101111111110111
11111111111101111111110111
11111111110000110000100011
11000001110000110000100011
11000000000000000000000011
11000001110000110000100011
11111111110000110000100011
11111111111101111111111111
11111011111101111111111111
11111011111101111000001111
11100001110000111000001111
11100000000000000000000011
11100001110000111000001111
11111111111101111000001111
11111111111101111111111111
11111111111101111111111111
11111111110000100011111111
11100001110000100010000111
11100000000000000000000111
11100001110000100010000111
11111111111111100011111111
