11111111111111111111111111
11111111111200111111111111
11111111111000111111111111
11111111111000111111111111
11111111111101111111111111
11111111111101111111111111
11111000111000111111111111
11111000111000100000011111
11100000000000000000011111
11111000111000100000011111
11111000111000111111111111
11111111111101111111111111
11111111111101111111111111
11111111111101111100011111
11100000100000011100011111
11100000000000000000000111
11100000100000011100011111
11111111111101111100011111
11111111100000011111111111
11111000100000011111110001
11111000100000011000110001
11111000000000000000000001
11111000100000011000110001
11111111100000011111111111
11111111111111111111111111
11111111111111111111111111
