33333333333333333333333334
60000000000000000000000004
60000000000000000000000004
60000000000000000000000004
60000000000000000000000004
60000000000000000000000004
60000000000000000000000004
60000000000000000000000004
60000000000000000000000004
60000000000000000000000004
60000000000000000000000004
60000000000000000000000004
60000000000000000000000004
60000000000000000000000004
60000000000000000000000004
60000000000000000000000004
60000000000000000000000004
60000000000000000000000004
60000000000000000000000004
60000000000000000000000004
60000000000000000000000004
60000000000000000000000004
60000000000000000000000004
60000000000000000000000004
60000000000000000000000004
55555555555555555555555554
