11111111111111111111111111
11111111111200111111111111
11111111111000111111111111
11111111111000111111111111
11111111111101111111110111
11111111111101111111110111
11111111110000111111100011
11111111110000111000100011
11110001110000000000000011
11110001110000111000100011
11000001111101111111100011
11110001111101111111111111
11111011111101111111111111
11100000110000011111011111
11100000110000011111011111
11100000110000011000000111
11100000000000000000000111
11100000110000011000000111
11100000110000011111111111
11111011111101111111111111
11111011100000011100011111
11111111100000011100011111
11111111100000000000000111
11111111100000011100011111
11111111111111111100011111
11111111111111111111111111
